#########################
#########################
#########################
#########################
#########################
#########################
#########################
###....#####P###....#####
###.###.########.###.####
###.###.####.###.###.####
###....#####.###....#####
###.###.####.###.########
###.###.####.###.########
###.###.####.###.########
#########################
#########################
#########################
#########################
#########################
#########################
#########################
